########################################
#                               ########
###### ########## ######################
###### ########## ######################
######     ###### ######################
########## ###### ######################
########## ###### ######################
###        ###### ######################
################# ######################
#################          $############
################# ######################
################# ######################
################# ######################
################# ######################
################# ######################
################# ######################
################# ######################
################# ######################
########################################